tx_hash,tx_sent_time,tx_mined_time,latency,gas_used,block_num,block_time,num_tx_in_block
0x06a4db8cf0ac66b3a752ba42af8b93fbc0ee0d88a5ad4acf43a4391bf8932204,1699975830,1699975838,8,62803,242,5,14
0xa0accac6b202cbffd8fe25aa8dd74a2aa9f47620ef52f3238e4e806c75b18719,1699975832,1699975838,6,61393,242,5,14
0x1caf264109a2c85b72c901c263c54cd7bce8a7e9119ca002a6c937b885e5ceb7,1699975834,1699975838,4,68285,242,5,14
0xd269310e616f1e4063d1132b49bae1b6800add1c892102dc00cc2d74b6c0623b,1699975838,1699975843,5,58603,243,5,21
0xcb2417a66f161709b1aba8fc0226e924e549c6024f774b387a22943bc193ebfa,1699975839,1699975843,4,101249,243,5,21
0x603273d231ec55be25b088096feb760e2d1bd4f7727a8179b3c55c01ed8a1bdf,1699975841,1699975843,2,64085,243,5,21
0x5acd37c0d45abbc25e9b4e16d133a14ce72486594bf48c7eeb13e7a5d6532f62,1699975845,1699975848,3,62803,244,5,30
0xb8199a1a29c68be7a61f46fe3d209e97085b1e4820344134ac11a08b79c7970b,1699975846,1699975853,7,69695,245,5,22
0xcd3f59a7b6f0eb0b5262ce3381dc0dc6ddb786126acf3dc6fad3ea417943e6fd,1699975848,1699975853,5,103990,245,5,22
0x10c952268b7551165c563ef8d2c3a47c08b073e3f469575c79b9808feeebdf26,1699975852,1699975858,6,62803,246,5,12
0x5cf430d6818700a56317ac6107bf218bba1c9274964685fca22df695306092be,1699975854,1699975858,4,69695,246,5,12
0xa5959ac64f9861a971e739bb71230f08c1ec47b1efbf727f0a4cc59f872503d5,1699975856,1699975858,2,68285,246,5,12
0x0ea7e5b517cdb70099f6f43cc24563def789100d2dca1376de53fb3803f1e028,1699975860,1699975863,3,62754,247,5,30
0x0054eceff36f14ed19d079c97ef63590eae2876faaf3e3258f77e8d834f172ac,1699975862,1699975868,6,65495,248,5,16
0xf8cd1fde86a941d85ccaf86b38f4ec26c43fa03dc9f5e62a33a5b8de5c859e07,1699975864,1699975868,4,103990,248,5,16
0x82a2e803a84151fcab181ac73e4642dc93590994c89aac6337fa54325afccdc2,1699975868,1699975873,5,62803,249,5,17
0x9f5208a05d4f99c258ffd32c5b1c7734a9263083aa2725ccbb3c7491b952061a,1699975870,1699975873,3,61393,249,5,17
0x96ba5ce50f15a0aa2552df74dbd0c83275816965228a79b1c0f983e69eadb6c1,1699975872,1699975878,6,68285,250,5,28
0x5139b5a93bbe0d69e665ee0117f7f429b5fbd66c9cfaf249fb0e5c6661cf7eff,1699975877,1699975883,6,58603,251,5,5
0xc96627d25d611ac0e21b73591cafa9f51b715b29f9035f4af880382eee281b3c,1699975878,1699975883,5,101249,251,5,5
0x900e5309095f8a0aa098c5c5ad0a5cff9bef62a5fb56a9e6fd8e4227a85f0f76,1699975880,1699975883,3,64085,251,5,5
0x0836587034cf546c1d94ab6662ab8b7c8258511c1d8782f8652ba59e6838fdec,1699975885,1699975888,3,62803,252,5,30
0xaaa79a9ac006d8c56cd05dd9bd1dc885896b826bc5ac2715735f90cb7b406b01,1699975886,1699975893,7,69695,253,5,25
0xb24913ecb11e463d7a7b89690dec0bce1a848fe3a44037f363c78234338f9338,1699975888,1699975893,5,103990,253,5,25
0xdff2cd6392df93b3b42432acad721aca001e74574314fc61818f354d7da8927d,1699975892,1699975898,6,62803,254,5,8
0xe90b3dd9a2c33bf83208149eb16010bb6b2d69cf8201ec263ed9ce5395caf5d1,1699975894,1699975898,4,69695,254,5,8
0xa4868fd5688fd5d1e37f34986f4370ba8e1cc9e6e9bb4e479e9d6aac6891f123,1699975896,1699975903,7,103990,255,5,31
0xc4763231d5ff79a69e6b622c71672e09674f248bcb527c7bd283105cac0418df,1699975900,1699975903,3,62803,255,5,31
0x9f005a366e8a9c2d51f473a7dbd57b7a91c4f818f8d1caca9267b6f8df55a2a4,1699975902,1699975908,6,69695,256,5,12
0xa37fee59d656ca4f5ecb7e6f561923787e1bfb0a400bcdd5c99137b3ffda4558,1699975904,1699975908,4,103990,256,5,12
0x3d41710e7a2a466335c3a8eda1b72f966d403f325271d27a0f53bf863311d8ee,1699975908,1699975913,5,62803,257,5,21
0x11b2788777a8fbe8a97f404aaa5f522e29cd263b31bc553560f64c887f9ff581,1699975910,1699975913,3,61393,257,5,21
0xc0ee0bbd24498e80c67a32eb1db747d17db70a6c615f19622ace4b89619488ad,1699975912,1699975918,6,68285,258,5,31
0x4f31372b028b5361a1531f93e37a4e4fd296d53e7ab13fe377e5fbc678dde914,1699975915,1699975918,3,58603,258,5,31
0xd7363a3a20082a4914167cc7e7e288f3c0da01b222657f41bd85313992e72289,1699975917,1699975923,6,101249,259,5,28
0xb84fa2579548cb613f4fded0709e52894b7f26620b9df51cf424b972068a2413,1699975919,1699975923,4,64134,259,5,28
0x4038294134d521124b7938b482c21f9a32ce48def6537f0d3ef8e06f2025fe81,1699975922,1699975928,6,62803,260,5,6
0x3e424931cc813e8cb530840d64b27f337ccb87c155586826a85f1f2af4c9bd98,1699975924,1699975928,4,101249,260,5,6
0x6e00b1f3250c12b7aff4554978877ad9b575c17d36d6d934264235491c39b25f,1699975926,1699975928,2,64085,260,5,6
0xba98999b9a00a0cfea454a058a7939330dbe4a667af87e6d72b79dd970cb016c,1699975930,1699975933,3,62803,261,5,30
0x2fb33f1adf3427cbd84ca777e8f1e688cb8adeefa62a5b675d7f1e3e20166e03,1699975932,1699975938,6,69695,262,5,24
0x95e138e8ca70aed4c4757c00b1317f857c21aa6e860b8f830474fdcc76595611,1699975934,1699975938,4,103990,262,5,24
0x644caa7340746e0e8c9c1e517a966b008ce4ecb66acf2ff0da8cd6062d35de46,1699975938,1699975943,5,62803,263,5,9
0x3ced89b8e4ca63f464bf1bff925bd9ca9a60aded7f3051d1ad4dbfe98e0949d4,1699975940,1699975943,3,69695,263,5,9
0x61dbf169c8d3a5020ee18db5d2586a07d74db49a1af81ec329a4d33b5fe6e33d,1699975942,1699975948,6,103990,264,5,31
0xc8450be84a06328082088d0e913d8a306f51a51d3921e48ae1a9310f5b972b88,1699975946,1699975948,2,62803,264,5,31
0xcbf5ef0aff6a34f25e831131f338b64daa10e5ee02d63b29ef8d09b41632fa85,1699975948,1699975953,5,69695,265,5,6
0xd874c931ee2c0c24cce91f21814323d7d4c4e99bc47e335818e933bdb9fb33ba,1699975950,1699975953,3,103990,265,5,6
0x0b9b2a021a7ef48168e029d34635a5f91918fa0430c98e055b05692b3e143191,1699975954,1699975958,4,62803,266,5,27
0x52aa29e4d8562c661b93285e1a1021239753f62807e70cd504058e997aaec229,1699975956,1699975958,2,61393,266,5,27
0xb24004dee8df91788dbdb26eb7743872d01200b935c7cf3bb3b301aa624f73ce,1699975958,1699975963,5,68285,267,5,18
0x2a4bd5f09d47246f464492858b92f01acd9af34158299d6aa23f33464f014883,1699975962,1699975968,6,58603,268,5,15
0x373e14ea0f0a27b8a94d813668530fc63b97a89adc19c4fc35d18bd9f943cf81,1699975964,1699975968,4,101249,268,5,15
0x4f48408d16a9ccb08f7bc33fd1f4921dd768c05c702c50e880d4b373ce8966bc,1699975966,1699975968,2,64085,268,5,15
0xa8799574630c26de3056d8228a6b992740e3150341901d0489b78df21d48301d,1699975971,1699975973,2,62803,269,5,30
0xf0bc6862a91a3d0afbed068183e5c12c4beef418953f1b3776d8bd8440bdf13d,1699975972,1699975978,6,69695,270,5,7
0x1f79e9d5d02288f9389dacf9052cfc7170af425956ad8b2b6526df7a2db589b4,1699975974,1699975978,4,103990,270,5,7
0x644cc1483b9add1073d09f73268559ce1636e4e67afe191935b0f7cbc0eb80b0,1699975979,1699975983,4,62803,271,5,26
0xe39a312f573a052f9f7b010310acdd405c4449edf55aabba3a7afe3cafb21d74,1699975981,1699975983,2,61393,271,5,26
0x506885f809e3f058a82cc8347380e29b200fc0ce4a3aa7f8f5577d353e222e69,1699975983,1699975988,5,68285,272,5,29
0x5735493aad4b7ffcc68b6285319cebd15efc90345ce2b421335cb62e632e4684,1699975988,1699975993,5,58603,273,5,3
0x0d51f60a7da2501bddcf349fa17da1a8a3687f6548c141cff0db6aa8695975b9,1699975990,1699975993,3,101249,273,5,3
0x4c15f53fb54d9d4f93ede93dffeda6e4b12cf6aebabdfb4ce9b70f1ba860f9f4,1699975993,1699975998,5,64134,274,5,17
0x937ca01fe373f6b3c3608c5961a86099f6cc9420bb44154137f55ba4eb680b61,1699976000,1699976003,3,62803,275,5,14
0xf7c592c5afc3d6c7f3b3a7c99991c1c978de5f73ea22bb53996b3498535d624d,1699976002,1699976008,6,101249,276,5,2
0x947cd9a9031d28f3b453aceb780239d1f7684f52dd4127c817fa70fec524709e,1699976004,1699976008,4,64134,276,5,2
0x9537f0d0dc03d20b01a405f5f676bd69a531f70170de064b2588fcb9d9a4d068,1699976011,1699976013,2,62803,277,5,30
0xe09611fc5f744674da03c02e8e37b31c216f37c9bb483041d9c38fdef0cdcc40,1699976013,1699976018,5,101249,278,5,2
0x61f9b5f46df0e4e68a3c86b7fd2622d009db32fbe4328bbfcdbc23ac2962dd12,1699976016,1699976018,2,64085,278,5,2
0x90a4b47d53a7a527ee83e0b0b8d89d50eeb583dcc36bac44847e2a0b4e068ba4,1699976021,1699976028,7,62803,280,5,3
0xaa5cb6df5c89899fbe70ecc58049b030517abdd8c916c27eab34b89e82dcb7d7,1699976023,1699976028,5,69695,280,5,3
0xdb5d9f7187ba064a104def880b9c2a52d05a4f7b85b0514f27e61ee85b6eed57,1699976025,1699976028,3,68285,280,5,3
0x48ffbf71d8cc430788bcbdf804e91ebaec536ea5367cc9d224082a9579c53168,1699976029,1699976033,4,62754,281,5,30
0xdf14c8a86a30ffc8ba58d350565ad414b3d3dd452244d839395cdcf200f74842,1699976031,1699976038,7,65495,282,5,30
0xcd3a12bc50d5433e2900fe621f4b4933f858348899b5d3cd955358cfdfd0afad,1699976033,1699976038,5,103990,282,5,30
0x6bd9ea19fa1e49bf83e02e53f4b06ed9a035a8b1fad66cd0428f08a444b1d351,1699976037,1699976043,6,62803,283,5,3
0xa22337ef5663c14b256ce6e2f382c9a40afd0d5fa251ba7245fb5373020bcc50,1699976039,1699976043,4,69695,283,5,3
0x7b6a7407780f8979ae151daaefe284ccaf7b0141ae5575b40208463784555ab4,1699976041,1699976048,7,103990,284,5,31
0xed2b8eaa1f5a17d8efb7c286fe3266b48c72147ab882c755d0296d4fa4905e67,1699976045,1699976048,3,62803,284,5,31
0xa37291923162a5ee0dc9d506a661f7158689ad6676b77d6bbd97da6fdc3a3f83,1699976047,1699976053,6,69695,285,5,16
0x3e0681b90db73fae71ece56ce0b30455b43a41e5a487554c60f4fdf81a0b77dc,1699976049,1699976053,4,103990,285,5,16
0xa61d2c2be3b42235704da8ddcdb19afaf21089e405308f6153ddb84615971888,1699976053,1699976058,5,62803,286,5,17
0xc158c66d492b72c57885cc69ab09b12472409114b98794382e13d81996eecb90,1699976055,1699976058,3,61393,286,5,17
0xf354761165b0288ecf8025e1e39a97c558a9b717ab33e6128c69043e775251ad,1699976057,1699976063,6,68285,287,5,30
0xbf179860c9b3e467c2ec5a2405a3401b213085ff5a76515cdcd1d4931e1379e0,1699976061,1699976068,7,58603,288,5,3
0xc3c2fae4e6d3a6a3474ff5161f12a10eb53b7b4a71d2333d9555c05f7ed04e43,1699976063,1699976068,5,101249,288,5,3
0xe89913c3dc4bc7f8773e5e194843a99a676ee5c22196f285359516f1d077d551,1699976065,1699976068,3,64085,288,5,3
0xb31cfa3739b6b011ade935e4bdad0a84d20317204550aa62710bc846ad9acc7e,1699976070,1699976073,3,62803,289,5,30
0x6c6f7af256632d898e1608106d64b051b5d0286251c065911879b78e85d80022,1699976072,1699976078,6,69695,290,5,21
0x4270c02850e3d4ab5464936962804a9028667020bede5ca1a9fbe3061bf1526c,1699976074,1699976078,4,103990,290,5,21
0x862c279f635d038d565c1d09c7ab32d1810a9ca3cb6ab162efdbe59f8ffc7170,1699976078,1699976083,5,62803,291,5,12
0xb100455a2fb811bcc256edff5a2461b120c17faf0547bf9ce1a2f2761672419b,1699976080,1699976083,3,69695,291,5,12
0x4f71839b3dcaa29538093e8bdbeaa3bbc0283a1f51d87a9518d4d4f1e5687efe,1699976081,1699976088,7,103990,292,5,31
0x4e7458d68b0051f1650da255fb8cba48baa475fde152e939d714ec0754b83862,1699976085,1699976088,3,62803,292,5,31
0x993bdac067810a3021a260d2f6791cd5e361b6aa1d4c6a8897e29f1113eeb4fe,1699976086,1699976093,7,69695,293,5,29
0x84f5d1afef6c8465ac4eb3fb560c619448b11a9d870ae82b48979a9485d980e1,1699976088,1699976093,5,68285,293,5,29
0x3431dfc5357c606a53f68f8bc7604a5fa2dd4a10573ca42a97e876cfcfd60993,1699976092,1699976098,6,62754,294,5,4
0x28694468fee2f9e2d966100fe46b917a9f3955cad29fda5a60c86c50cd392b65,1699976094,1699976098,4,65495,294,5,4
0x896f187a75fcd2f72dd867f01088212c8f888211b70b39fbc65e0b728a2d522e,1699976096,1699976103,7,103990,295,5,31
0x38c7f197ceae3d5b904b48940df418fdb65cead469cce352c0d39dfee5a4102c,1699976101,1699976103,2,62803,295,5,31
0x11b3083da5f2bcef22c72357b0959eb7342266affb0171424e84969a7d6d4bb1,1699976103,1699976108,5,69695,296,5,12
0x3644b39c61c966c2a2ab7ecaa7ed0dc74f4bc41b202085b682976d3030450358,1699976104,1699976108,4,103990,296,5,12
0xa1949273a1b43f69b1b2a5cabe5fb811c03c2fcb260f3f29e5e274567063a1f1,1699976109,1699976113,4,62803,297,5,21
0xb8d614a341e6923ce9d6d8e009001199e7cd925e72194bc1549f04af58c623c3,1699976111,1699976113,2,61393,297,5,21
0x1996cfedf6ea5f942ff0d411675cacc053b8336a5e65a8196c8a6553ecb10929,1699976113,1699976118,5,68285,298,5,30
0xec92c406eedfe1d31a8d0631ef3881642853e9a2ad098c27718e8459bc914a2a,1699976117,1699976123,6,58603,299,5,3
0xa018ccbf8ba91df94071a8dbcf660092070b2ad69b6c25cf20843c82a33b8304,1699976119,1699976123,4,101249,299,5,3
0x4bf6b6bce9b9b7da66d1ee1bfc409512d50d2960a8c2b9719deffaf46001e4e5,1699976121,1699976123,2,64085,299,5,3
0xdab00f3b287b03405c2b38ab0fde80e058cda1b0b775c17675621ea0f99237a3,1699976125,1699976128,3,62803,300,5,30
0xca8a58a0567d0e42c5a2027b007af67b2fd6a1d2b9c2474060756c8bb469a533,1699976127,1699976133,6,69695,301,5,20
0xe88ee1e54e38b0d7a86f067406dcea665b1fb268c3f7b5597fdd406be250f9f5,1699976129,1699976133,4,103990,301,5,20
0xba3e9e4606e9c2f68af366124e8f215b55d5ed7dfc938215a5cd7bb6c804ce99,1699976133,1699976138,5,62803,302,5,13
0x3514e229d87a79322b1e200324207255e5dd8ebff668673bdd49e79234ec0248,1699976135,1699976138,3,61393,302,5,13
0x6bbf647adc4938d2521bbe5ce49d0c473233aca3b5b73cbdbf03e972603e73f3,1699976137,1699976143,6,68285,303,5,30
0x8f3732f93fac50f5f1ea9399d3b31bbd84af2ab669143d5bc347ece73bc7d28a,1699976141,1699976148,7,58603,304,5,3
0xba36eeb08765e28ad39d6a4c86085463526eacddb4d550a7ece27ef991cbfbe4,1699976143,1699976148,5,101249,304,5,3
0x0fd42ca7dd91d9fb66d6bdd6d1bd0237bfa95895c13f88f4e32535d6c2f47b1a,1699976145,1699976148,3,64085,304,5,3
0xdb110236bd288294cf0846297f0600d5f644447532d84e6490e846c0470ff36e,1699976149,1699976153,4,62803,305,5,30
0x0cd73f0f7221e7d36d25f1045ad24609681465fb0d92fd900b348ce8a494e4a9,1699976151,1699976158,7,69695,306,5,26
0x410b5594d07bf2ec959664d0a7248f7e13db156bf4be5576d8a35a7454f9edbd,1699976153,1699976158,5,68285,306,5,26
0x09e33d324395eb303d1847e5b6ed1c67c8a7a8f0eccd894fd5cc97da15c20f49,1699976157,1699976163,6,62754,307,5,7
0xbc7a8c09dc4214e3abcba9126a4d9813e284d144c0d71833d8114b9b3497b6a3,1699976159,1699976163,4,65495,307,5,7
0xcd2fe5f1b5b39e8b0fad32c63c943bd93830bb80dbeb056b780a6d0c6acd1739,1699976161,1699976168,7,103990,308,5,31
0xa6eeb13767142e55a9a3243cc8c2810263f36597ee893e1b12b4002928933186,1699976166,1699976168,2,62803,308,5,31
0x3ce0f5a8ef57164165f39199f059e9868386dd5b2e7db6b1ef4ee18c747a379b,1699976168,1699976173,5,69695,309,5,7
0x67c05d050cf1836116c98019101cb9f3dce252d6fa4df7d4fe12737aa4d5789b,1699976169,1699976173,4,103990,309,5,7
0xa6a5af25f46c514aa2c2b4d7d49190fd653e398a0f8436ea97a9145b7ff97634,1699976174,1699976178,4,62803,310,5,26
0x6f9cd80904fd2983086f9186858f10fc1960f61030d072c4a3771057c131e507,1699976176,1699976178,2,61393,310,5,26
0xcfb03f49a8160588ed426d794f80ad429a22633b5346295e2cbb2a513c361294,1699976178,1699976183,5,68285,311,5,25
0x8dc8537cfab8d92a5290a1c0c4fc6fceec9ff1d7203c0d2a104fa8adbbe6eafc,1699976182,1699976188,6,58603,312,5,8
0xc7f6b7ae6d151cb08a35d790f0d3e475a7708980ffff1ec88a902d653342f19f,1699976184,1699976188,4,101249,312,5,8
0x1e3f13c5af711271bce6e122965081500a0061ebd4616be8e21e4a18af0ec1dd,1699976186,1699976188,2,64085,312,5,8
0x1ddfa7c8fd01f1c7117b7649ab9923cf597bb752f05fbc5a4c7d2c2afd6273ec,1699976190,1699976193,3,62803,313,5,30
0xdd193e4128e76c5d995190699682c4c93000916921dc63b44247b9b470c4f7fa,1699976192,1699976198,6,69695,314,5,10
0x83b52d794d934393dd6e12241f1da5395d96985e813e8c038ac15c6500f8e112,1699976194,1699976198,4,103990,314,5,10
0x20d1f58132c23ddfe9b11ee5bfb1cd1d1cce796dceb7d87c4d550c6956640da3,1699976199,1699976203,4,62803,315,5,23
0x69215fd6c28047d5014d7f54f405357b1e147e81c30724e10325f9ff789d2913,1699976201,1699976203,2,61393,315,5,23
0x931bc5659647ec315d3588e2ed54d4cd20ab13cf115d75bfe5026bba6e9a42e8,1699976202,1699976208,6,68285,316,5,30
0x58013adebd679fb9567435e54cd1e62113e1784dd351d2d4af45d4b675574941,1699976207,1699976213,6,58603,317,5,3
0x1e8fe36e759e3ddc7707cde5a7a73e774d96b8326a00b69b9cb34a2200a28c8f,1699976209,1699976213,4,101249,317,5,3
0x0b415154810ffb81f612cbcb096db518e05edb3c21161a957cb917d358e4daf3,1699976211,1699976213,2,64085,317,5,3
0x63c4050a3d026fda0f8b584ab3755010179c4f00b4fe07eeb65966d8e85a2d57,1699976214,1699976218,4,62803,318,5,30
0xb09f224c562a2c2376d73095a8a487fbeff9a3717f7a50434f98af4566275e99,1699976216,1699976223,7,69695,319,5,28
0x579d872daaa1f1e05e49332ca8f5171d05861cc419028577bf92fec305b9d9b1,1699976218,1699976223,5,68285,319,5,28
0x65dd909262bc21e515d0e8b52f4cb63235ba403b0b270b9b362a6db0a4d3496c,1699976222,1699976228,6,62754,320,5,5
0x989a526229ac6662cabf907ece431833ef1fbf6ec48e911034efbffb02f14174,1699976224,1699976228,4,65495,320,5,5
0x9ebe9bd6459dd151d93126fa00fff63ad80b5b52688c09caa7b6438037c35bf0,1699976226,1699976233,7,103990,321,5,31
0x39f22fec78dda97f79333275458c1e6a6e7d1311a8fea28a78094a46f4364a97,1699976231,1699976233,2,62803,321,5,31
0x52c851c9df47b148bcd93dfadd120dd54427c2c198874d922d1b2a8ae9c77978,1699976232,1699976238,6,69695,322,5,7
0x2fd86ee982c54f45246936412422626dbf3fc3137ef56b598f9faf417940ab2a,1699976234,1699976238,4,103990,322,5,7
0xea9436470a2655c08f9c4405b3a4d3e13ce080ac3054fed19b2ae0d5c3cb83a1,1699976239,1699976243,4,62803,323,5,25
0xc0e31020af19cab2ca22a89fbf1d93cd2750ad0359c2dee2ae1cca81949314e9,1699976241,1699976248,7,61393,324,5,31
0xb3937324008606d7f9e19c5f3ee27a88f0f7ccbf3f75269b2b8acf91b6b86fae,1699976242,1699976248,6,68285,324,5,31
0x2bbfb463d07bee3772fbcfd077a156f066058d2eeac7c6e0b0c34e96d497ec2c,1699976247,1699976253,6,58603,325,5,3
0x52074ccdc39ddbb191babe6a5300ec60197319cb419b3e5c35c1dc395486bcde,1699976249,1699976253,4,101249,325,5,3
0x8c93060b9014f86436f50029e9ccf595386c37ddc4542d28a5235bc614a010d6,1699976251,1699976253,2,64085,325,5,3
0x98bd364c320753b775bece3da36c4b8e53196f08811e87a0e0f5ec3053b14c5e,1699976255,1699976258,3,62803,326,5,30
0xc17c1f0fe06e9aeffa520c4ddafe6f298e1fe8eb6d9a899a5b2e66fbf5e65789,1699976257,1699976263,6,69695,327,5,15
0xb5f49c7c7dec80c4fd7e5b991dd10fc9abd92d5707d954b2c3ecebcf2f2f294e,1699976259,1699976263,4,103990,327,5,15
0x04401a118344bf43f5355f410ddc8e1b85b27568bf77710400e14835048119a0,1699976263,1699976268,5,62803,328,5,19
0x5cf69a3297539b650d68be20686335fa87c5b2527ae6bdc5a0d7302ba1160193,1699976264,1699976268,4,69695,328,5,19
0xb41394d5cf37d2bcc9a914adfe4a8efc2685710e212ea51c8b1ab4f0e8137c40,1699976266,1699976268,2,68285,328,5,19
0x2d13a10edfde6c603dd606901609a20c99cf84de85a347a160801dc604dedc4b,1699976270,1699976273,3,62754,329,5,30
0x8df97cbabc73dcff48441722324a2c56a2c0207d8c2b8c34d7f9649c4ab3248c,1699976271,1699976278,7,65495,330,5,21
0xbd0d0ce295de759f8987f2b048dc5bb17b0787aca027fb31ee7d606685650328,1699976273,1699976278,5,103990,330,5,21
0x9500b8980a54a8788e920063c7ad06e931b5b47ca23894900d58dcb56e565afc,1699976278,1699976283,5,62803,331,5,12
0xde5c39c54ce7328e08f841073897885a8bccaba68a98d62b26c3b28fc6d0a93c,1699976279,1699976283,4,69695,331,5,12
0xa12419de8bd8bee86e5a3d451673344597b86148110413a19fe45b3389cf793d,1699976281,1699976288,7,103990,332,5,31
0xc1275dfd553eb2da960ff358111bb59add44492bb9272259f0feaa7d245c21f4,1699976286,1699976288,2,62803,332,5,31
0x36682d89233dbfaed789ebac9cdb5b97f8b42b8fa2bdf3704969d128aa263a98,1699976287,1699976293,6,69695,333,5,15
0xd419df198a5f9dcae7c94d9f0ef70968a19c8181584698a60b19c82ee3bf58f3,1699976289,1699976293,4,103990,333,5,15
0xaea6ecf30a22e8123839184db12f10fe71acb72fe39f9ba341503626cbf9f5b8,1699976294,1699976298,4,62803,334,5,18
0xdc4528c9c072761f379b34df218c6665a6fd2bb7462ba1f06ce28c9e3f9eb7ac,1699976296,1699976298,2,61393,334,5,18
0x42ad2c6ece198cd130a1b130f0e312016406894e5d28c37d3c1c194ab74b3aa1,1699976298,1699976303,5,68285,335,5,22
0xc8cf619a9bc7bd2b8f051757f7facfa342da11114d40509289983bdd870b3bba,1699976302,1699976308,6,58603,336,5,11
0x343f274c0112857791f18e9bbfc6fcfbb194f51ed872585a5aeaf2e0d3a1f438,1699976304,1699976308,4,101249,336,5,11
0x52d9e74e24bd5b138ce7b87d5ed955263dd2cda646b44c806dafffb9c9e3733a,1699976306,1699976308,2,64085,336,5,11
0xcc3ca227997b223ab135b416eb437f959d682d1e8e2006ae9a8a527943e1bfc1,1699976310,1699976313,3,62803,337,5,30
0xa9835600f9db4b38c00e66e56d5df20217dc51070cbe5e3b46c4aeb5ff9f5ae5,1699976312,1699976318,6,69695,338,5,7
0x53a80e15ddc60fae8be85febf3d636487386fd1c32e5ff02ec9951167f7161d0,1699976314,1699976318,4,103990,338,5,7
0xa6c1f2071bc961f492583e1ada520ea4eeee2446df25e689c5bf03b7de0a9245,1699976319,1699976323,4,62803,339,5,26
0xc06b55ce594b21fb829c882ee7b4e9d1fb4bd1f7a9c6c04020bcae8fc0233884,1699976320,1699976323,3,61393,339,5,26
0xc40a9114fb251d35bbb06bb9050d88a2045d9f4bea5200d67b4aa4f0eb42d0ce,1699976322,1699976328,6,68285,340,5,30
0xec0ddfa5e1b76d8aabbd4989349833705ca34f7d16549cde715cb11c387e6f4f,1699976327,1699976333,6,58603,341,5,3
0x4fe42767a6e23f83407c9038f8061ea44841465ef1f4ac0c11515100d56965be,1699976329,1699976333,4,101249,341,5,3
0x092ef4e37e23446db3c1d51a5abbcd75028951a311954cfb4c546f4e4bca3056,1699976330,1699976333,3,64085,341,5,3
0x3692f23551309cb8f457716679869ad6e9ff62738f67feb2d185f2e1e5816668,1699976335,1699976338,3,62803,342,5,30
0xd7b5c0758428da848909ff143f0d34ad23a67db1f5b0e73b19e455908ab71749,1699976337,1699976343,6,69695,343,5,18
0x4b63bef6bbd3a37b3dd0ef715c768a2f9b2f40c00411123bcbcff09624a957e6,1699976339,1699976343,4,103990,343,5,18
0xd28e9b74533b8ec4c5786540e4352d98fc6221d0e26b16cb9a1e721a18c5e1e2,1699976343,1699976348,5,62803,344,5,15
0x9d11ec00a2d2acff476149c029a7026fc5dcb36f9ff84703307a2283f296e091,1699976345,1699976348,3,69695,344,5,15
0xc6e5ffdf3d1d573829c7db50fbe190ff9e8ad7e0c6aa9534f38dba2ca072178f,1699976347,1699976353,6,103990,345,5,31
0x1690a4771e5bd0fb13b9c763118204ee8eca42c5878eada55edc349aa2fa572e,1699976351,1699976353,2,62803,345,5,31
0xfa7fc646f3121b3cefdc006eb7378c44f15e13281d892fe631b9ae240a1d7932,1699976353,1699976358,5,69695,346,5,6
0x3d62933ba7ec34e2b4d93653362553bb8428c48b4eb76dd95accc3aacc671150,1699976355,1699976358,3,103990,346,5,6
0x112e5aef5e1a51363a77982c85d88d4c8e383d34e69e13f6c26d0af0b10089e8,1699976359,1699976363,4,62803,347,5,27
0x9519a6e0af9bf9e51470c4120b429ce8e67dd04b70aba65bf7a99e4fc24ee237,1699976361,1699976363,2,61393,347,5,27
0xaa75248349ba18fb199cd9c1bce4aeeb8c9bf882897a4d25a93a8f4fb97c9fc5,1699976363,1699976368,5,68285,348,5,26
0xed2768eb136677ce8a01867b96e341e19605577d64659d6021c094ae744301c5,1699976367,1699976373,6,58603,349,5,6
0xd74895297c4127dfdfa8db6f3b32d24458d0cfd960e331fbcdbc1e2dd7110010,1699976369,1699976373,4,101249,349,5,6
0xeddbd1abc26303e90a43006e3d006ffe787bd45e68310d1ee24f1ed02ee7914f,1699976371,1699976378,7,64134,350,5,31
0x5c7d74a85eb24597e7b6abde96d43d909a7cc98003e08e929861b5d42d26b1e5,1699976375,1699976378,3,62803,350,5,31
0x96af11f62eb0baa78a8c2395a7e8a52fe6476467dd59b67a4fe88139924fb8b5,1699976377,1699976383,6,101249,351,5,10
0xc77a7ad0f8d365c4fc6d0089cf65c2ebf5256fdf5ae9b37f9cd5374c58f67769,1699976379,1699976383,4,64134,351,5,10
0x5d3f9b0f08ff9746ff17d81e6272b910454a70b582336c81822aa10afbc84c8c,1699976384,1699976388,4,62803,352,5,23
0x117abe138aa25b41713dc1d27e09519606b99a63323f3bfa195675293854899a,1699976386,1699976388,2,61393,352,5,23
0x5ced0ff691fef5bae09aa9b8b0a47e0ea33da75fc73613add668c24291cfb0b2,1699976388,1699976393,5,64085,353,5,23
0xcb8e51d64001a9202b5e4dcbfc1e1ca5104e4362107bd1d06ffb30bcdf90d0ab,1699976392,1699976398,6,58603,354,5,9
0xb94411ab02a900e86b8c26bf1857dd28b4b2f5330d5afeca509c0c635b70bf85,1699976394,1699976398,4,101249,354,5,9
0x8b97d2a4cb766deb3dbe22821854190e1359ced116124146c02b0cec9544c653,1699976396,1699976403,7,64134,355,5,31
0x4c29cf8e3e94f05c8b3b40e5066bcc22a5839b56897cbe7d41c92b1ec5942a31,1699976400,1699976403,3,62803,355,5,31
0x2b5665f06d6bdd1a08b7da7285cbfb2757d0cc2e21f9f4c556e7c6a6352d96ed,1699976402,1699976408,6,101249,356,5,13
0x55e86f5e4388e1a95632b76d121c83720a540cd62b1aa7e5dc454d9eb7ef1a6e,1699976404,1699976408,4,64134,356,5,13
0x4f4846aeaf66fb7f1e7a147b3ee7faea0e8643aa719db55e3e319a4df3157a9f,1699976407,1699976413,6,62803,357,5,21
0x8b8a4beaf702caea05ac96443acc77ac26e72436c2526ff5431d0a1e037adf18,1699976409,1699976413,4,101249,357,5,21
0x8b966e4c87663e369776d05126fc7a5e06b81f3a4a1c134468de1d7da25ccd7b,1699976411,1699976413,2,64085,357,5,21
0x525cd5535dd543777ac1c73d73a8814215eeb76a2b975c2253a877a9b9dcb0e7,1699976414,1699976418,4,62803,358,5,31
0x5c13397ce72f8d3ec73e64d0fe20a42507ea4e7a07513ebae34c8c1546adc6fa,1699976416,1699976418,2,61393,358,5,31
0xb3454a1e7991c440ae725bfdc4573839ec29cb2b564721352e39f55bb86234b6,1699976418,1699976423,5,68285,359,5,26
0x54cc418d97dfd3387274d04625ca94532eb997d318b661db7a5f64f2c8f8b2e2,1699976422,1699976428,6,58603,360,5,7
0x7874e0790443f4a4f690b483cd7918d82dc652f65ee4c169dda361fb0e2b7208,1699976424,1699976428,4,101249,360,5,7
0x704e8634b4ab0b82ac3cf6f29b38749f769ccdd6f256a354292831e36a3d4a74,1699976426,1699976428,2,64085,360,5,7
0x07d8ea51c73ae47ac28e1c083d60990a81990220ced209fa34fb714a4ecfc780,1699976431,1699976433,2,62803,361,5,30
0x7b00d5274db17f660d5e75c94ad4a000514fbded297f7c994d76cdd22a2ca948,1699976432,1699976438,6,69695,362,5,15
0xf6c501c3e594b9dc21fd0202623b98debe364f288cadb798f77a0aa38bbd94f6,1699976434,1699976438,4,103990,362,5,15
0xa1e5cf544c5b1d2d7dcec93ee89ab5b3bd7fa99baac40c0b1dda971b5f3b1b11,1699976439,1699976443,4,62803,363,5,17
0x5c195dd758642fa1502f5a229c40a622527b92ce7790aede5713710718ccf6fa,1699976441,1699976448,7,69695,364,5,26
0x1d763640186f7e5ebfc499b41dd8d50b500d6d0b58b52e5a9f642e94febfa929,1699976442,1699976448,6,68285,364,5,26
0xf327194be0032837219791f9417e745bd546eb5f76b98288fd0fb38e3905b18f,1699976447,1699976453,6,62754,365,5,8
0xb3d2b0387d1e8b22d5f4166c926bdff00d97f9d274d8bb5d9e4108b21104eac1,1699976449,1699976453,4,65495,365,5,8
0xe0ee87cf52e7d21d9f079298ae86b30b0fce357edba596e4cea65524e52eec74,1699976451,1699976453,2,103990,365,5,8
0x997edf3e10a73c2ca280d26e32bfee51c7fe27e058df1c6767256c045dfaeab6,1699976455,1699976458,3,62803,366,5,30
0x1f059319704719d3a37488992ec41b419c8f42bcb5edf3c8cdf9296c201bd4f3,1699976457,1699976463,6,69695,367,5,12
0x851cc266e740a3e54439d756d3f02231237e455704332c5d00b746be67ad6399,1699976459,1699976463,4,103990,367,5,12
0x6900c8475675d19a677e7d045cdd9b2b53282d92c51a5c7d902fd35992cca640,1699976463,1699976468,5,62803,368,5,21
0x976532cf5fb88ddbd0a07aa0a18e91d4a2dbf18fd59f7f8009cf823bdb9d1b5e,1699976465,1699976468,3,61393,368,5,21
0x27f9997b6691ff11a97c9957b8b3ca3aeecb91cadb128f996e7b7c93b46eb14e,1699976467,1699976473,6,68285,369,5,30
0xf3147311721c617f22843efda160017e6e2c6bf1f061dd617c6c6303d323cc45,1699976471,1699976478,7,58603,370,5,3
0x81e93dbcc72fc88fb4e9834d1d007711ffe3b00e0e075e1c8e7b4fa132a2900b,1699976473,1699976478,5,101249,370,5,3
0x33d679d11645082e5e5df9c08483a9a25786f174facd949d6c75ca1e604ba6fa,1699976475,1699976478,3,64085,370,5,3
0x5bbb70b9c1e9afbdbfb5cbb41fe6d00b3176c3e9400c705bbbf22a9e1ee31a46,1699976480,1699976483,3,62803,371,5,30
0xbbe172139facad927b29dbbbc6da2155b58ec89842375c8f34deafb433fbc970,1699976482,1699976488,6,69695,372,5,14
0x1feae88a9776fbc5ebca19b1227d1ece4a4f0a664fa6b61101f3bd8cd7919c72,1699976483,1699976488,5,103990,372,5,14
0x6a71fc4f18d01ba12b16585df8d10349026c78a6e3374227434bf63ab8017fc9,1699976488,1699976493,5,62803,373,5,19
0xd2827a03f92582a34c30e4930c9bcd44b94ec34784456d7953980b9de82ffc10,1699976490,1699976493,3,69695,373,5,19
0xabe0139ad60e7c60e2f824cc09ee2e3616f00954b0348a7fc0c95305703b151f,1699976492,1699976498,6,103990,374,5,30
0x9f5fb06a7203aaaaf9736a6bc463ce3f4705c11f74c972abd1bf1ad2b08e8a93,1699976496,1699976503,7,62803,375,5,7
0xcdbe0d84ce806694327f22a5d072a816925918a9c63234ca0376c4f26a734b13,1699976498,1699976503,5,61393,375,5,7
0x296ad2890c8704e47745afb9e205b8c1c2fe85149847e6d4300b483d6c7bc1b3,1699976500,1699976503,3,68285,375,5,7
0x490ffcf122ba60e8177c3a808cc2f373c7b2e2ed024f3dbe1ac7af02fd3079c9,1699976505,1699976508,3,58603,376,5,26
0x47b34bcdd6253dd2fe8ada7c0fed6802a748e61c310c4264f66ba93a43cde7a6,1699976507,1699976513,6,101249,377,5,23
0x2e4c187f3f5f3048a7e8e6539dcb92187aea449e4075e6ff746e486ae83aa0b2,1699976508,1699976513,5,64134,377,5,23
0x1ba04da9a9e4d1b694facf26278bf070d20abeef27efbd8d6da72d61e46769d0,1699976513,1699976518,5,62803,378,5,10
0x26891044c296a1827518d10868f85b8839b4adc7ec7345e81610698acd691292,1699976515,1699976518,3,101249,378,5,10
0x2fce2829f0869568fe48259c67bfad735403dc507c51a07e285f6bb4994ff486,1699976517,1699976523,6,64134,379,5,31
0x59cf801a97f8bfb77391986c6bc900ffb6ae442638723808557bb7e18829bd77,1699976521,1699976523,2,62803,379,5,31
0x61dc13a14a3590bb393571d68c2c775884c9c40057c7bca10c8e2a76c3d33207,1699976523,1699976528,5,101249,380,5,2
0x2b1b03c6e35d77e61fb350582f19401d4f2ba82f91bc74d6f54b9d6f27cf21a9,1699976525,1699976528,3,64085,380,5,2
0x5a5eda0c1cbd3765aec8aef69234c3ce0463369ab8f52d66941ed8dfd151b8bc,1699976530,1699976533,3,62803,381,5,30
0xe936a5bacc4ebc9dc368388b84fdd00c6a329c81914307cd4641d887280157e3,1699976531,1699976538,7,69695,382,5,20
0x728680b39da2ed09e8e93d7b8dc730cbf2ccd120f9d6cea043fc0af05c816e1d,1699976533,1699976538,5,103990,382,5,20
0x26b610827afc6d310f18664dfbcc125e5ce40f09575631d5e1d29c0f886cadb5,1699976538,1699976543,5,62803,383,5,13
0x58e7bc10808ac74247451dd1ba13194bfea21f420092dac58e7dca7e74d9c79c,1699976540,1699976543,3,69695,383,5,13
0x218969ad87e1c21735e45e411b4c11dcf4d794d5c588df69fd05bb2d7af33173,1699976542,1699976548,6,103990,384,5,30
0x48b7b8e2a5b280550f300abeab2286f834bfc0b33fbc177dd03ab80515396ce3,1699976546,1699976553,7,62803,385,5,11
0x9549e45fcf274abdf66fd7458005b521b15d5b42d35bc712f1ba6a140e529434,1699976548,1699976553,5,61393,385,5,11
0xeedc4ad85a3d8dba7e1908706abcb27f45a8abf2e5a4c9dd46b15a7ab2b8396a,1699976550,1699976553,3,68285,385,5,11
0xd4eb6da59251b3e15de449d3c0fdbee01955812f8aadb8bdbff4bb50dbb3bd9f,1699976554,1699976558,4,58603,386,5,22
0x3f023bb120eba3dd683826b72b7ef93ab6cf2758d2cc35fd6e2dfd174e254ce7,1699976556,1699976563,7,101249,387,5,26
0x1a670b44764a0d538b57a1fa92171114c2938d2de80c52b194ab840c6e1b9253,1699976558,1699976563,5,64085,387,5,26
0xc097bc90f49356a0b23bdcee1275eb47e02c90717abc9aeaff0911c79ffe1a17,1699976563,1699976568,5,62803,388,5,7
0x8a77da4befcb2fa706292b6b625aab0a618a157fb58e82e8cabbed52b5af60ac,1699976565,1699976568,3,61393,388,5,7
0x3343b4b6a7ce88fa17551493732b648cb71b683fabc65e5be407ce0cb4986ebd,1699976566,1699976573,7,68285,389,5,31
0x23ed542e8cad4b95624194c7163e48aa2028e4add4f0cb5c7381bbb21a4dfab9,1699976571,1699976573,2,58603,389,5,31
0xccdbfc79323e6d7703d76e9a1771716d94177035d55b46acea335fc297a010b8,1699976573,1699976578,5,101249,390,5,2
0x5e18bc84cb1dba6995335524a9903e2dc06a376d6999b1c7aff212694ad94121,1699976575,1699976578,3,64085,390,5,2
0x8b6dd38d3a6eb5cd7e423bb79b1f34d393bb90414de26353d0dc91441903d0ef,1699976579,1699976583,4,62803,391,5,30
0x3ca39c6601f48197172bcb27fcd02d13ead5dc6e401fcb382babb31f6ae73e2e,1699976581,1699976588,7,61393,392,5,17
0x8b83d0b84102a08a4b118f1cabf191608406ddb511b3cf765413efc706a366e1,1699976583,1699976588,5,68285,392,5,17
0xf87fc5dee10fb22baf9fc956038e9b61480366f63bc0f6ac33552b09cfcb704a,1699976588,1699976593,5,58603,393,5,16
0x7ecc6f8176a2f213a882f7fd3ed94b0db266e1dc0a0824c8812f317ea78dca4a,1699976590,1699976593,3,101249,393,5,16
0x6e3d499f222368ef0bf788619f135c7cb0b82d45f9515d4524b9d44aea111366,1699976592,1699976598,6,64134,394,5,31
0x3e8c831d820c859ddbdb4622d46cf34a3aeb683d38da487751994a851b97de9a,1699976596,1699976598,2,62803,394,5,31
0x55889ab09416f7e3d1b19626f6ed450f145c7273e90abbce2ace834c79c32f4c,1699976598,1699976603,5,101249,395,5,10
0xcb11ca92752dcee64e81b9d9a46f5e183c51de11a0ffb2a46ad43dbb3649a1e8,1699976600,1699976603,3,64134,395,5,10
0x63e119c0394d5a7a27128607d6d97c6e631e5a2aa80ac355a0e6e9d4c55657e2,1699976603,1699976608,5,62803,396,5,23
0x716e9f7f01edb8e73ffee2b935072292744053223543c0955bcf132bb6ce1f9d,1699976605,1699976608,3,61393,396,5,23
0xa0d058357884bba0c17eb1ee6d8c0e57ca89c732bc884ba3dde4df2a257f95f2,1699976607,1699976613,6,64085,397,5,30
0xea2da4d103a5ae228259fce996e49cce8cae532cc79731d8581ba075f4ced62a,1699976611,1699976618,7,58603,398,5,3
0xa21768e9ae6f6bdef8324636ca765fd357d642ad7a231e365aeedf5a52271668,1699976613,1699976618,5,101249,398,5,3
0xbe234005d9478fb9f35cfdf7e9364350fe6f3baeabeb50fba84e5bb102cfac49,1699976615,1699976618,3,64085,398,5,3
0x50b0721d16f6944c759590b6c3f05b93a814ce03e8b7c22984503693be07bbf5,1699976620,1699976623,3,62803,399,5,30
0xf17b53193a59e968358d2a683caa5d8b9e7618f35d412372b4911ca2d9371801,1699976622,1699976628,6,69695,400,5,17
0x6d8773e39b552c9c3dc5ceca6ae8f024ebd793ce8591b42e4db4d519c0ae045c,1699976624,1699976628,4,103990,400,5,17
0x13f63e52ebb1a16cc5480f507fc24ec41df8574b5221b8c207fc23998a51b217,1699976629,1699976633,4,62803,401,5,16
0x7275df713a6f24b213964b68dc275b09465a29c0409acfb7aece42bdd417e36c,1699976631,1699976633,2,61393,401,5,16
0xe4760fd56e18244eccb63e0b7d3339770194c726ec1939304c2fc91151be653d,1699976633,1699976638,5,68285,402,5,27
0x4acede0dbd6b8192d2d56a70e32c70efdc7fcb4ebc5abce131fa7a5ff43fefee,1699976637,1699976643,6,58603,403,5,5
0xfc0c4f3587403b0afc1190cd530cf99b83ca37835c8b712c40aeb03d248d224b,1699976639,1699976643,4,101249,403,5,5
0x3c78fa17c1a1b9504385e596ffe12cfde71c39bc67e5f1589880449253eb3a69,1699976641,1699976648,7,64134,404,5,1
